############
#..........#
#........#.#
#........#.#
#........#.#
#........#.#
#........#.#
#........#.#
#........#.#
#........#.#
#........#.#
#........###

############
#..........#
#.#######f.#
#.#......#.#
#.#......#.#
#.#......#.#
#.#.###..#.#
#.###.#..#.#
#.....#..#.#
#.#####....#
W.#........#
P.##########
