111111111111
1..........1
1........1.1
1........1.1
1........1.1
1........1.1
1........1.1
1........1.1
1........1.1
1........1.1
1........1.1
1........111

111111111111
1..........1
1.1111111f.1
1.1......1.1
1.1......1.1
1.1......1.1
1.1.111..1.1
1.111.1..1.1
1.....1..1.1
1.11111....1
W.1........1
P.1111111111
