############
#..........#
#.########.#
#.#......#.#
#.#......#.#
#.#......#.#
#.#.###..#.#
#.###.#..#.#
#.....#..#.#
#.#####..#.#
#.#........#
#.##########

############
#..........#
#.########.#
#.#......#.#
#.#......#.#
#.#......#.#
#.#.###..#.#
#.###.#..#.#
#.....#..#.#
#.#####..f.#
W.#........#
P.##########
