..l.1.1.
........
#121#.#.
.l..1.#.
.l..1.##
.#1#1#.#

..l.1.1.
........
W121B.#.
.l..1.#.
.l..1.##
.W1#1#.P
